%%%%%%%%%%%%%%%%%%%%%%%%%%%%%%%%%%%%%%%%%%%%%%%%%%%%%%%%%%%%%%%%%%%%%%%%%%%%%%%%%
%P      %       %   % %     %   %   %   %             % %   %         %     %   %
%   % %%% % %%% % % % % % %%% % % % % %%% %%% %% %%%% % % % % % %%%%% % %%% %%% %
%   %     % % %   % %   %   % % % % % %   % % %     % %   %   %     %   % %     %
%%% %%%% %% % %  %% %% %% % %%% % % % % %%% % %%%%% % % %%%%% %   % % %%% % % % %
%   % %     %     %     % %   %   % % %     %     % % %     %   %       %   % % %
%   % % % %   % % %     % % % %%% % % %%%%% %%%%% % % %%%%% % % % %%% % %%% % %%%
% %   % % %   % % %     %   %     % %       %     % %     %   % %     %   %     %
% %%% % %%% % %%% % %  %% %%% %%% % %% %%%% % %%%%% %     % %   %% %% %%% % %%% %
% %       % % %   % %   % %     % %     %     %           % %       % %   % %   %
% % %%%%% % % % %%% % % %%% %%% % %%    % %%%%% %%% %%% %%% % %%%%% %%% %%% % % %
%   %   %   % %     % %     %           % %   % % %   %     %     %     %   % % %
% % %%% %%%%% % % %%% % % %%% %%%%%%% %%% % %%% % %%% % %% %%%%        %% %%% % %
% %         % % %   % %   % % %       %   %       % %   %         %     %   % % %
% % %%% %%%%% % %%% % %%%%% % % %%%%%%%%% %% %%%% % %%%%% %% %%%%%%% %% %%% % %%%
%   %   %     %   %   %       %         %       %   %   % %   %           % %   %
%%% % %%% %%%%% %%%%%%% %%% %    %% %%% %%%%% % %%% % %       % % %%%% %%%% %%% %
%       % %           % %   %         %         % %   %   % % % %   %     % %   %
% %%%%%%% % %%%%% %%% % %%% % %%%%%%% %%%%%%%%%%% %%% %%% % % % %%% % %%% % % %%%
%         %     %   % %   % %   %   %   %   %     %     %   %   % %     % % %   %
%%%%% % %%%%%   %%% % %%% % %%% %%%     % % %%% % % %%% % %%%%%%% %%% %%% % % % %
%     %   %   %   % % %   %   %           %     %   %   %         %   %   % % % %
% %%%%%%% % % % % % % % %%% % %%%%% % %%%%%%% %%%%%%% %%%%%%% %%% %%% % %%% % % %
%       % % %   % % % % %   %     % %       % %   %   %   %     %   % %   % % % %
%%% %% %% % %%%%% % %%% % % %  %% % %%%% %% %%% % %%%%% % % % % %%% % %%% % %%% %
%         %   %   %   % % % %   % %       %     %       % % % %   % %   % %     %
% %%%%    %%% % %%% % % %%% %%% % % %%% % % % %%% % %%%%% % %     % % % % %%%%% %
%   %     %   % %   %       %   %   %   % % %   % % %     % %     % % % %     % %
% % %%% %%% %%% %% %%%%%%%%%% %%%%%%% %%% % %%% % % %%% % % % %%%%% %%% %%%%% % %
% %           %                       %   %     %       %   %               %  G%
%%%%%%%%%%%%%%%%%%%%%%%%%%%%%%%%%%%%%%%%%%%%%%%%%%%%%%%%%%%%%%%%%%%%%%%%%%%%%%%%%
