%%%%%%%%%%%%%%%%%%%%%%%%%%%%%%%%%%%%%%%%%%%%%%%%%%%%%%%%%%%%%%%
%                                                             %
%                                                             %
%                                                             %
%                                                             %
%                                                             %
%                                                             %
%                                                             %
%                                                             %
%                                                             %
%                                                             %
%                                                             %
%        P                                      G             %
%                                                             %
%                                                             %
%                                                             %
%                                                             %
%                                                             %
%                                                             %
%                                                             %
%                                                             %
%                                                             %
%                                                             %
%                                                             %
%                                                             %
%                                                             %
%%%%%%%%%%%%%%%%%%%%%%%%%%%%%%%%%%%%%%%%%%%%%%%%%%%%%%%%%%%%%%%
