%%%%%%%%%%%%%%%%%%%%%%%%%%%%%%%%%%%%%%%%%%%%%%%%%%%%%%%%
%                                                      %
%                                                      %
%                                                      %
%                                                      %
%                                                      %
%             .-.-.-.-.-.-.-.-.-.-.-.                  %
%        P    -----------------------   G              %
%              ---------------------                   %
%               ...................                    %
%                                                      %
%                                                      %
%                                                      %
%                                                      %
%                                                      %
%                                                      %
%%%%%%%%%%%%%%%%%%%%%%%%%%%%%%%%%%%%%%%%%%%%%%%%%%%%%%%%
