%%%%%%%%%%%%%%%%%%%%%%%%%%%%
%............%%............%
%.%%%%.%%%%%.%%.%%%%%.%%%%.%
%..........................%
%.%%%%.%%.%%%%%%%%.%%.%%%%.%
%......%%....%%....%%......%
%%%%%%.%%%%% %% %%%%%.%%%%%%
%......   %.    .%   ......%
%%%%%%.%% %%%%%%%% %%.%%%%%%
%............%%............%
%.%%%%.%%%%%.%%.%%%%%.%%%%.%
%....%....    P       %    % 
%%%%.%.%% %%%%%%%% %% %.%%%%
%......%%    %%    %%      %
%.%%%%%%%%%% %% %%%%%%%%%% %
%...........              G%
%%%%%%%%%%%%%%%%%%%%%%%%%%%%
