%%%%%%%%%%%%%%%%%%%%%%%%%%%%
%............%%............%
%.%%%%.%%%%%.%%.%%%%%.%%%%.%
%..........................%
%.%%%%.%%.%%%%%%%%.%%.%%%%.%
%......%%....%%....%%......%
%%%%%%.%%%%%.%%.%%%%%.%%%%%%
%.........%......%.........%
%%%%%%.%%.%%%%%%%%.%%.%%%%%%
%............%%............%
%.%%%%.%%%%%.%%.%%%%%.%%%%.%
%....%........P.......%....%
%%%%.%.%%.%%%%%%%%.%%.%.%%%%
%......%%....%%....%%......%
%.%%%%%%%%%%.%%.%%%%%%%%%%.%
%.........................G%
%%%%%%%%%%%%%%%%%%%%%%%%%%%%
