%%%%%%%%%%%%%%%%%%%%%%%%%%%%%%%%%%%%%%%%%%%%%%%%%
% .  %        .%             %  .%     % %   %. %
%    %%%% %%%%%% %  % % %%         %%%%  %  %%% %
%    %.%    % .% %  % %  %   %   %          %   %
%   .            %.     %%%% %   %% .%%% %      %
% %%%%% %%%%%%  %%%% %           .%    %. %%%%%%%
%.      %   .%       .% %%%  %%%%%%  % %  %   % %
%%% %%  % %%%%%%% %%%%% %    %  . %% % %    %.% %
%    %  %      %  %      P% %%       %   %%%% % %
%.      %   %  %  %     %          %       .%   %
% % %%%    % %    %% %% %%% %% %  % %%%%%%%%%%% %
%   %.   %    %              %    %G       .    %
%%%%%%%%%%%%%%%%%%%%%%%%%%%%%%%%%%%%%%%%%%%%%%%%%
