%%%%%%%%%%%%%%%%%%%%%%%%%%%%%%
%      P      .%      .  .   %
%   %%%%% %%%%%% %  % % %%   %
%   %. %     %   %  % %  %  .%
%.     %     .   %.   %  %%%%%
%%%%% %%%% %%%  %%%%%%%     .%
%.               .    % %%%  %
%% %%%%%%%% %%%%%%%%%%% %    %
%       %               % %%%%
%       %%%%%     %.         %
%.% %%%    %  %   %% %% %%%%%%
%G         % .%             .%
%%%%%%%%%%%%%%%%%%%%%%%%%%%%%%
