%%%%%%%%%%
%.  % .  %
% %.% %%G%
% %   .%.%
% .%P%   %
%.  .  . %
% %%%% % %
%. .   %.%
%%%%%%%%%%
